2 4 3 3 3 3 3 4 3 3 3 3 3 3 3
2 0 0 0 0 0 0 0 0 0 0 0 0 0 2
2 0 0 0 0 0 0 0 0 0 0 0 0 0 2
2 0 0 0 4 0 0 0 0 0 0 0 0 0 2
2 0 0 0 0 0 0 0 0 0 0 1 0 0 2
5 0 0 0 0 0 0 0 0 0 0 0 0 0 5
2 0 0 0 0 0 0 0 0 0 0 0 1 1 2
2 0 0 0 0 0 A 0 0 0 2 2 2 0 2
2 0 0 0 0 0 0 0 0 0 2 0 0 0 2
2 0 0 2 0 0 0 0 0 0 D 0 0 0 2
2 0 0 0 0 0 0 0 0 0 2 0 0 0 2
2 3 3 3 3 3 3 3 3 3 3 3 3 3 2