2 4 3 3 3 3 3 4 3 3 3 3 3 3 3
2 . . . . . . . . . . . . . 2
2 . . . . . . . . . . . . . 2
2 . . . 4 . . . . . . . . . 2
2 . . . . . . . . . . 1 . . 2
5 . . . . . . . . . . . . . 5
2 . . . . . . . . . . . 1 1 2
2 . . . . . A . . . 2 2 2 . 2
2 . . . . . . . . . 2 . . . 2
2 . . 2 . . . . . P D . . . 2
2 . . . . . . . . . 2 . . . 2
2 3 3 3 3 3 3 4 3 3 3 3 3 3 2